1111111111111
100000C0C1101
10P0000000011
1000000000001
1111111111111